	Операции вне среды
+SH	

	Операции над средой
+HELP	- справка по словам.
+LIST 	- вывод списка слов
+SHOW 	- распечатка состояния стеков
+VARL 	- распечатка списка переменных
+TYPL	- распечатка списка новых типов
+EXIT	- выход из интерпретатора

	Типы переменных
+VOID	- переменная раделитель в стеке
+UDEF	- неопределенный тип
+BYTE 	- метка типа
+LETR 	- создание символа
+CHAR 	- метка 2 байтного символа
+INT 	- метка типа
+DUBL 	- метка типа
+TEXT 	- метка типа
TIME 	- метка типа время
+DOT	- многомерная точка
+VEC	- вектор (модификатор типа)
+UVEC 	- делает вектор единичной длины.
+MAT	- матрица 3x3
+MATX	- матрица 4х4
+PATH	- траектория, состоящая из точек (пока)
+=IDX	- модификатор типа на индекс массива и аксессор к данным сложных типов (массивов и структур)
+DIM 	- модификатор типа на размерность
FORM 	- модификатор типа на формат строки вывода
BTOL 	- (byte to literal) - модификатор типа в символ
ITOC 	- (int to char)	 - модификатор типа в символ
+AS  	- преобразование типа переменной.
+EXE	- установление флага автоматического выполнения текста или строки
+XEX  	- снятие метки выполнения с текста.

	Операции с числами
+ADD 	- сложение чисел и добавление строки к тексту, сложение строк, траекторий
+INC 	- увеличения целого числа на единицу
+DEC	- уменьшение целого числа на единицу
+SUB 	- вычитание чисел
+NEGA 	- отрицание
+MUL 	- умножение
+DIV	- деление
+MOD 	- остаток от целочисленного деления
+EXP 	- экспонента
+LOG	- логарифм
+ABS	- абсолютная величина числа
+SIGN	- знак числа
+POW	- возведение в степень	
+SQRT 	- корень квадратный
+COS	- косинус
+SIN 	- синус
+TAN	- тангенс
+ACOS 	- аргкосинус
+ASIN	- аргсинус
+ATAN 	- аргтангенс
+NMAX	- нахождение максимального из ряда
+NMIN	- минимальное из чисел
+NAVE	- среднее арифметическое 
+MMUL	- умножение матриц
MADD	- сложение матриц
+SMUL	- скалярное умножение векторов
+VMUL 	- векторное произведение 
+VADD	- сложение векторов
+VSUB	- вычитание векторов
+INV 	- инверсия вектора (и матрицы)
VORG 	- задание начала вектора (??)
MROW	- выделение ряда матрицы
MCOL	- выделение колонки матрицы
MTRA	- транспонирование матрицы
+LEN	- получение длины вектора (модуль)
+RAND 	- генерация случайного числа.

	Создание переменных	
+VAR 	- создание переменной
+NAME	- переименование переменной.
+STRI 	- создание строковой переменной (модификатор типа?)
+ARRA	- создание массива
=STRU 	- создание структуры
=NEWT 	- создание новой сигнатуры типа
+DEL 	- удаление переменной полностью
+ADEL	- удаление автоматических переменных
+LOCK	- блокирование переменной от удаления
+UNLO	- разблокирование переменной от удаления
+AVAR	- делает переменную автоматической.
SYNO 	- создание синонима имени переменной или слова

	Операции с объектами
=+EQ 	- присвоение значения (работает для любых типов)
+QE		- присвоение значений переменной, значение после имени. 
ADDR	- получает значение адреса поля структуры по имени? (безымянные переменные?)
+PRIN 	- вывод N аргументов
+PR 	- выводит 1 аргумент и убирает его со стрека
+DROP 	- удаление некого числа элементов из стека
+SWAP 	- менять 2 ячейки
+ROT	- циклическая ротация
+DUP	- дупликация 1 ячейки стека (2 ячейки если дабл)
+DUPS	- дублирование строки, с выделением области для значения.
+TYPE 	- помещение в стек типа переменной
+VALU 	- помещение значения переменной в стек
+FLIP 	- перекидывание значений из одного стека в другой
+FLOP 	- перекидывание значений обратно
+PUSH 	- перекидывание одного значения из основного стека в дополнительный
+POP	- перекидывание одного значени из дополнительного стека в основной.
+LN 	- создание ссылки на переменную или 
-RENA 	- переименование переменной
+SP 	- указатель на вершину стека.
+CS 	- очистить стеки полностью, удалить все элементы в нем, переменные не удаляются
+NEL 	- количество элементов в сложном объекте.
+=PUT		- присвоение значений массива к элементам массива.

	Операции со строками
+SPEL->RUN	- Вытягивает содержимое строки и подает на вход интерпретатору (использовать RUN)
+HEAD 	- отрезание начала строки, отрезание начала текста, конец отбрасывается
+TAIL 	- отрезание конца строки, отрезание конца текста, начала отбрасывается, символы считаются от конца
+=GLUE	- склеивание строки из символов или подстрок, склеивание текстов, склеивание строк в текст.ad
FIND 	- поиск фрагмента в строке
REPL 	- замена фрагмента в строке
+CUT 	- вырезание фрагмента в строке
COPY 	- копирование строки
+PACK 	- склеивание многих строк в текст

EDIT 	- режим редактирования
END 	- выход из режима редактирования
+: 		- эскейп последовательность отмена команды
WORD 	- создание нового слова
IS 		- завершение создания слова
+RUN 	- запуск интерпретации или выполнения слова или запуск слова на интерпретацию
STOP 	- прерывание выполнения потока дочернего процесса (???)
NLIN	- форматирование вывода, нумерация строк вывода
SNIP 	- вырезание фрагмент текста 
LDEL	- удаление строки текста
LINS	- вставка строки текста
LREP 	- замена строки текста
COMP 	- компилировать слово
RIPS 	- распечатать дамп памяти по адресу
?DO ...  - начало цикла
+LOOP  	- повторение оператора заданное число раз
+REPE 	- условный цикл
---UNTL - условный цикл
\ 		- перевод строки, отмена интерпретации всей строки и коментарий
+#		- комментарий до конца строки
+IF		- условный оператор
+ELSE	- условный оператор
---THEN	- условный оператор
AND 	- логическое и
OR 	 	- логическое или
XOR 	- логическое исключающее или
NOT 	- логическое отрицание
EQ 		- равно
GT 		- больше
LT 		- меньше
LE 		- меньше либо равно
GE 		- больше либо равно
NE 		- не равно
CONT 	- возвращение к началу цикла
BRK		- пропустить до конца цикла
SKIP 	- пропустить определенное количество слов в стеке после этого.
BAND 	- (binary and)
BOR 	- (binary or) 
BXOR  	- (binary xor)
BNOT  	- (binary not)
+NTOA   	- преобразование числа в строку
ATON 	- преобразование строки в число
ITOB  	- обрезание числа до байта
ISES	- пустая строка - проверка на пустую строку
DISK	- устройство файловой системы
---CREA 	- создать файл (может и не нужно) --- заменено на SAVE
FDEL 	- удалить файл
DERR 	- код ошибки
SYNC	- синхронизация
+SAVE 	- сохранение файла
+LOAD	- загрузка тексового файла
+APEN	- дописать строку или текст к существующему или новому файлу.
LINK  	- связь между областями
ULIN	- отмена связи между областями
UART	- компорт
TOUT 	- команда задания таймаута
BRAT (bitrate)  - задание скорости порта
PARI (parity) 	 - четность
SBIT			- стопбиты
DATA 	- внутренняя память среды


	Время
DATE 	- получение даты
+TICK 	- возвращает количество секунд стандартной даты. 
+USEC 	- возвращает количество микросекунд стандартной даты
+WAIT 	- пауза

	Дополнительные операции с текстом и строками

SPLI	- разгрупировка строки или текста на независимые строки или подстроки, текстовая переменная уничтожается
---SPLI 	- разбиение строки на отдельные символы
FIND 	- поиск фрагмента в строке, тексте
REPL 	- замена фрагмента в строке, тексте
COPY 	- текста
DUPS	- дупликация строки, с выделением памяти, (может быть текста)
SLEN	- получение длины строки

COMN	- выделение общей подстроки из двух строк
LEVD	- расстояние Левенштейна.
FIND	- поиск по маске в строке или в тексте.
FINDD	- поиск слова в словаре.
SORT	- сортировка текста по ключам
FUZZ	- нечеткий посик по словарю
ADIC	- добавление записи в словарь.
RDIC	- удаление записи из словаря.
RDUB	- удаление одинаковы строк в тексте, слов в строке, записей в базисе.
PARS	- представление некой строки или текста по базису.
PLAY	- восстановление последовательности из базиса.
IFIX	- корректировка индексов 

--PREP	- вставка (строки) в начало (текста) -- Вставка в начала строки будет то же самое что и 0 INS
--APPN	- вставка (строки) в конец (текста) -- Вставка в конец строки будет то же самое что и -1 INS
+INS 	- вставка фрагмента в строку, в текст
	
	Стандартный ввод-вывод

+CIN 	- ввод текста из клавиатуры, который помещает ввод в строку в стек.

	Операции с дочерними процессами

ASYN 	- запуск дочернего интерпретатора
HOLD 	- остановка и ожидание завершения дочернего интерпретатора
MAMA 	- имя родительского интерпретатора, отправка сообщения родителю
CHAN 	- создание канала для чтения-записи
MAP		- установление проекции данных на переменную
UMAP 	- удаление проекции данных на переменную
---?TOP		- канал связи с суперпроцессом
---?BOT 	- канал связи с субпроцессами
SEND 	- канал связи с одноуровневыми процессами для отправки
RECI	- канал связи с одноуровневыми процессами для получения
